10
10
##########
#    C   #
#        #
#        #
#        #
#        #
#        #
#        #
#    S   #
##########