10
10
##########
# C  #   #
#  2#  # #
#8 ## ##3#
##  # 4  #
# #### #2#
#  9## # #
##  # ##7#
# # 6 S# #
##########